32,32@
44111111111111111111111111111111;
41444411111111111111111111111111;
41111144444111111111111111111111;
44144111114444411111111111111111;
44444111111411444411111111111111;
44114411111411114441111111111111;
24444411111444111444114411111111;
42421421214414111414441144111111;
46444411226414111414411114411111;
68411422246644444414411111411111;
66814442116614144441411111141111;
16811411462614144441411111141111;
11666146666412424441411111141111;
11116664116411424444411111141111;
11111111446444421144111111141111;
11111111122421211144111111141111;
11111111116241111144111111441111;
11111111116112421414411114411111;
11111111116441112211144444111111;
11111111116114424211211116111111;
11111111116121241111111116111111;
11111111116211111111111116111111;
11111111112111111111211116111111;
11111111112661111111211116111111;
11111111112216661112111161111111;
11111111111112216662666611111111;
11111111111111112221111111111111;
11111111111111111111111111111111;
11111111111111111111111111111111;
11111111111111111111111111111111;
11111111111111111111111111111111;
11111111111111111111111111111111;
$